2020o - 2020 Bulkers
HUGOo - 5th Planet Games
ABGo - ABG Sundal Collier
ABLo - ABL Group
ADEo - Adevinta
AEGAo - Aega
AFGo - AF Gruppen
AGLXo - Agilyx
AIRXo - Airthings
AKASTo - Akastor
AKERo - Aker
AKBMo - Aker BioMarine
AKRBPo - Aker BP
ACCo - Aker Carbon Capture
AKHo - Aker Horizons
AKSOo - Aker Solutions
AKVAo - AKVA Group
AMSCo - AMSC
ABTECo - Aqua Bio Technology
AQUILo - Aquila Holdings
ARCHo - Archer
AZTo - ArcticZymes Technologies
AFKo - Arendals Fossekompani
ARRo - Arribatec Group
ASTKo - Asetek
ATEAo - Atea
ASAo - Atlantic Sapphire
AUSSo - Austevoll Seafood
AUTOOo - AutoStore Holdings
AGASo - Avance Gas Holding
ALNGo - Awilco LNG
ACRo - Axactor
B2Io - B2 Impact
BAKKAo - Bakkafrost
BELCOo - Belships
BGBIOo - BerGenBio
BEWIo - BEWi
BNORo - BlueNord
BONHRo - Bonheur
BORo - Borgestad
BORRo - Borr Drilling
BRGo - Borregaard
BOUVo - Bouvet
BWEo - BW Energy
BWLPGo - BW LPG Limited
BWOo - BW Offshore
BMAo - Byggma
CADLRo - Cadeler
CARAo - Carasent
CRNAo - Circio Holding
CLOUDo - Cloudberry Clean Energy
CONTXo - Contextvision
CRAYNo - Crayon Group Holding
DNBo - DNB Bank
DNOo - DNO
DOFGo - DOF Group
EAMo - EAM Solar
EWINDo - Edda Wind
EIOFo - Eidesvik Offshore
EMGSo - Electromagnetic Geoservices
ELKo - Elkem
ELABSo - Elliptic Laboratories
ELMRAo - Elmera Group
ELOo - Elopak
ENDURo - End�r
ENSUo - Ensurge Micropower
ENTRAo - Entra
EQNRo - Equinor
EQVAo - Eqva
EPRo - Europris
FLNGo - FLEX LNG
FROo - Frontline
GIGo - Gaming Innovation Group
RISHo - GC Rieber Shipping
GENTo - Gentian Diagnostics
GJFo - Gjensidige Forsikring
GOGLo - Golden Ocean Group
GODo - Goodtech
GCCo - Gram Car Carriers
GSFo - Grieg Seafood
GYLo - Gyldendal
HAFNIo - Hafnia
HAVIo - Havila Shipping
HEXo - Hexagon Composites
HPURo - Hexagon Purus
HSHIPo - Himalaya Shipping
HBCo - Hofseth BioCare
HUNTo - Hunter Group
HYPROo - HydrogenPro
HAUTOo - H�egh Autoliners
IDEXo - IDEX Biometrics
IOXo - Interoil Exploration and Prod.
ITERAo - Itera
JINo - Jinhui Shipping and Transport.
KAHOTo - Kahoot!
KIDo - Kid
KITo - Kitron
KCCo - Klaveness Combination Carriers
KMCPo - KMC Properties
KOMPLo - Komplett
KOAo - Kongsberg Automotive
KOGo - Kongsberg Gruppen
LSGo - Ler�y Seafood Group
LINKo - Link Mobility Group Holding
MGNo - Magnora
MEDIo - Medistim
MOBAOo - Morrow Bank
MOWIo - Mowi
MPCCo - MPC Container Ships
MULTIo - Multiconsult
NAPAo - Napatech
NAVAo - Navamedic
NKRo - Nekkar
NELo - NEL
NEXTo - NEXT Biometrics Group
NORBTo - NORBIT
NORCOo - Norconsult
NOMo - Nordic Mining
NODo - Nordic Semiconductor
NORSEo - Norse Atlantic
NHYo - Norsk Hydro
NSKOGo - Norske Skog
NORTHo - North Energy
NODLo - Northern Drilling
NOLo - Northern Ocean
NASo - Norwegian Air Shuttle
NRCo - NRC Group
NYKDo - Nykode Therapeutics
OBSRVo - Observe Medical
OTSo - Oceanteam
ODFo - Odfjell A
ODFBo - Odfjell B
ODLo - Odfjell Drilling Ltd
OTLo - Odfjell Technology
OKEAo - Okea
OETo - Okeanis Eco Tankers
OLTo - Olav Thon Eiendomsselskap
ORKo - Orkla
OTECo - Otello Corporation
OTOVOo - Otovo
PENo - Panoro Energy
PARBo - Pareto Bank
PCIBo - PCI Biotech Holding
PSEo - Petrolia
PNORo - PetroNor E&P
PEXIPo - Pexip Holding
PGSo - PGS
PHLYo - Philly Shipyard
PHOo - Photocure
PPGo - Pioneer Property Group
POLo - Polaris Media
PLTo - poLight
PRSo - Prosafe
PROTo - Protector Forsikring
QFRo - Q-Free
QECo - Questerre Energy
RANAo - Rana Gruber
REACHo - Reach Subsea
RECSIo - REC Silicon
ROMo - RomReal
SDSDo - S.D. Standard ETC
SAGAo - Saga Pure
SALMo - SalMar
SALMEo - Salmon Evolution
SACAMo - Salmones Camanchaca
SASNOo - SAS
SATSo - SATS
SCANAo - Scana
SCATCo - Scatec
SCHAo - Schibsted A
SCHBo - Schibsted B
SBXo - Seabird Exploration
SEAPTo - Seacrest Petroleo Bermuda
SDRLo - Seadrill Limited
SSGo - Self Storage Group
SBOo - Selvaag Bolig
SHLFo - Shelf Drilling
SIOFFo - Siem Offshore
SIKRIo - Sikri Group
SMCRTo - SmartCraft
SOFFo - Solstad Offshore
SRBNKo - SpareBank 1 SR-Bank
SNIo - Stolt-Nielsen
STBo - Storebrand
STROo - StrongPoint
SUBCo - Subsea 7 S.A.
TECHo - Techstep
TEKNAo - Tekna Holding
TELo - Telenor
TGSo - TGS
TRMEDo - Thor Medical
TIETOo - TietoEVRY Oyj
TOMo - Tomra Systems
TREo - Treasure
ULTIo - Ultimovacs
UNIVo - Univid
WAWIo - Wallenius Wilhelmsen
WSTEPo - Webstep
VEIo - Veidekke
WWIo - Wilh. Wilhelmsen Holding A
WWIBo - Wilh. Wilhelmsen Holding B
VISTNo - Vistin Pharma
VOLUEo - Volue
VVLo - Voss Veksel- og Landmandsbank
VOWo - Vow
VARo - V�r Energi
XXLo - XXL
YARo - Yara International
ZALo - Zalaris
ZAPo - Zaptec
